11 21
*********************
*s    *     *       *
* *** * *** * ***** *
* *   *   *   * *   *
* ******* *** * * * *
*   *   *   *   * * *
*** * *** * ***** * *
*     *   *   *     *
* ***** * ***** *****
*       *   *      f*
*********************
